15.ox
..........o....
.........1.....
.o.......1.oo..
.....o..o1...oo
.........1.....
.........1....o
.........1.....
.....o...1o....
.........1.....
...o.....1.....
.........1.....
.........1.....
........o1.....
.........1o....
.........1.....
